111111111111111111
100001000000000001
1011111100000000E1
100010000011100001
100000000001000001
100000000010000001
100000000010000001
110111111110000001
1P0000000000000001
111111111111111111
