111111111111111111
10000100000C000001
101111110C000000E1
100010000011100000
1000000C0001000001
100000000010000001
1000000C0010000000
11C111111110000001
1P00C00C0000000001
111111111111111111
