111111111111111111
10000100000C000001
101111110C000000E1
10001000001101
1000000C0001000001
100000000010000001
1000000C0010000001
11C111111110000001
1P00C00C0
111111111111111111
